dog	animals
cat	animals
lion	animals
tiger	animals
elephant	animals
giraffe	animals
zebra	animals
bear	animals
wolf	animals
monkey	animals
rabbit	animals
mouse	animals
horse	animals
fox	animals
cow	animals
sheep	animals
goat	animals
deer	animals
camel	animals
pig	animals

apple	fruits
banana	fruits
grape	fruits
orange	fruits
lemon	fruits
cherry	fruits
pear	fruits
peach	fruits
plum	fruits
kiwi	fruits
mango	fruits
papaya	fruits
pineapple	fruits
watermelon	fruits
blueberry	fruits
raspberry	fruits
strawberry	fruits
fig	fruits
date	fruits
apricot	fruits

red	colors
blue	colors
green	colors
yellow	colors
purple	colors
orange	colors
pink	colors
brown	colors
black	colors
white	colors
gray	colors
cyan	colors
magenta	colors
beige	colors
teal	colors
lime	colors
maroon	colors
navy	colors
olive	colors
gold	colors

car	vehicles
bus	vehicles
truck	vehicles
bike	vehicles
motorcycle	vehicles
train	vehicles
airplane	vehicles
helicopter	vehicles
boat	vehicles
ship	vehicles
scooter	vehicles
tram	vehicles
submarine	vehicles
taxi	vehicles
van	vehicles
jeep	vehicles
skateboard	vehicles
ferry	vehicles
canoe	vehicles
rocket	vehicles

germany	countries
france	countries
italy	countries
spain	countries
portugal	countries
netherlands	countries
sweden	countries
norway	countries
denmark	countries
finland	countries
poland	countries
austria	countries
switzerland	countries
greece	countries
belgium	countries
ireland	countries
czech	countries
slovakia	countries
hungary	countries
croatia	countries

soccer	sports
basketball	sports
tennis	sports
baseball	sports
cricket	sports
rugby	sports
golf	sports
boxing	sports
volleyball	sports
handball	sports
hockey	sports
badminton	sports
cycling	sports
skiing	sports
swimming	sports
surfing	sports
skating	sports
climbing	sports
rowing	sports
archery	sports

chair	furniture
table	furniture
sofa	furniture
bed	furniture
desk	furniture
wardrobe	furniture
shelf	furniture
cabinet	furniture
stool	furniture
bench	furniture
couch	furniture
drawer	furniture
mirror	furniture
cupboard	furniture
nightstand	furniture
armchair	furniture
ottoman	furniture
dresser	furniture
lamp	furniture
bookcase	furniture

hammer	tools
screwdriver	tools
wrench	tools
pliers	tools
saw	tools
drill	tools
chisel	tools
axe	tools
mallet	tools
level	tools
tape	tools
shovel	tools
rake	tools
hoe	tools
spanner	tools
cutter	tools
file	tools
sander	tools
trowel	tools
pickaxe	tools
